########
#      #
#      #
# XXX  #
#      #
#   XX #
#     $#
########
