########
#      #
#B     #
#XXXX  #
#B  X  #
#X  XX #
#     $#
########
