########
#      #
#B     #
#XXXX  #
#      #
#   XX #
#     $#
########
