########
#      #
#B     #
#XXXX  #
#B  X $#
#XXXXX #
#      #
########
